####E###########################################################################
#           #           #           #       #           #       #              #
#           #   @       #  $        #   @   #     $     #     $ #  # #   # #   #
#           #           #           #       #           #       #  #  # #  #   #
#########   #########   #####   #   #   #   #   #####   #   #   #  ##  #   ##  #
#       #   #           #       #       #           #       #   #              #
#   @   #   #     @     #       #   $   #      $    #       # $ #     ###      #
#       #   #           #       #       #           #       #   #        #     #
# $ #   #   #   #########   #############   #####   #   #########       #      #
#   #           #       #   #           #       #   #           #        #     #
# $ #       $   #   $   #   #     $     #    @  #   #        @  #     ###      #
#   #           #       #   #           #       #   #           #              #
# $ #   #########   #   #   #####   #   #########   #   ########################
#   #               #       #       #               #           #              #
# $ #        @      #       #   @   #       $       #           #              #
#   #               #       #       #               #           #              #
# $ #   #####   #############   #########################   #####              #
#   #   #                   #   #               #               #              #
# $ #   #   @     @    @    #   #   $   @  $    #     $      $  #              #
#   #   #                   #   #               #               #              #
#####   #   #####   #####   #   #   #########   #   #############              #
#       #       #   #   #       #   #   #   #   #   #           #              #
#       #     $ #   # $ #       #   # @ # $ #   #   #    $      #              #
#       #       #   #   #       #   #   #   #   #   #           #              #
#   #####   #####   #   #########   # $ #   #####   #   #####   #              #
#   #       #       #   #           #   #       #   #       #   #              #
# @ # $     #   @   #   #     @     # $ # @     #   #    @  #   #              #
#   #       #       #   #           #   #       #   #       #   #              #
#   #####   #   #####   #   #########   #####   #   #########   #              #
#       #   #               #           #       #               #              #
#    $  #   #               #           #       #        $      #              #
#       #   #               #           #       #               #              #
#########   #   #####   #####   #########   #####   #############              #
#           #   #   #                   #                       #              #
#   $  @  $ #   #   #         @         #                       #              #
#           #   #   #                   #                       #              #
#############   #   #   #####   #####   #########               #              #
#               #           #   #                        *      #              #
#  @   $   $    # @       $ # $ #     @                         #              #
#               #           #   #                               #              #
#   ######### $ #############   #####   #########               #              #
################################################################################