################################################################################
#                                                #              #              #
#  $   @   $                                     #              #  # #   # #   #
#                                                #              #  #  # #  #   #
#      $      #                                  #     *        #  ##  #   ##  #
#             #                                  #              #              #
#  $   @   $  #                                  #              #      ##      #
#             #                                  #              #     # #      #
###############                                  ############   #       #      #
#                                                               #       #      #
#                                                               #      ###     #
#                                                               #              #
#                                                               ################
#                                                               #              #
#                                                               #              #
#                                                               #              #
#                                                               #              #
#                                                               #              #
#                   ########           ########                 #              #
#                   #                         #                 #              #
#                   # @                $   $  #                 #              #
E                   #                    $    #                 #              #
#                   # @                $   $  #                 #              #
#                   #                    $    #                 #              #
#                   # @                $   $  #                 #              #
#                   #                         #                 #              #
#                   ###########################                 #              #
#                                                               #              #
#                                                               #              #
#                                                               #              #
#                                                               #              #
#                                                               #              #
#                                                               #              #
#   ############                                  ###############              #
#              #                                  #             #              #
#  $   @   $   #                                  #  $   @   $  #              #
#              #                                  #             #              #
#      $       #                                  #      $      #              #
#              #                                                #              #
#  $   @   $   #                                     $   @   $  #              #
#              #                                                #              #
################################################################################
