#################################E##############################################
#          ###               ##     ##             ###          #              #
#          ###               ##  [  ##             ###          #  # #   # #   #
#    [     ###       [       ##     ##      [      ###     [    #  #  # #  #   #
#          ###               ##     ##             ###          #  ##  #   ##  #
#          ###               ##  $  ##             ###          #              #
#                            ##     ##                          # ## ### ## ## #
#                             ##   ##                           # # ## ##  #   #
#                             ##   ##                           # ## # # #  #  #
#       #########             ##   ##           #########       # # ## #  #  # #
#      ###########                             ###########      # ## ##### ##  #
#       #########                               #########       #              #
#         #####                  #                #####         ################
#                               ###                             #              #
#           [         $        #####        $       [           #              #
#                    $ $      #######      $ $                  #              #
#                     $      #### ####      $                   #              #
#                           ##### #####                         #              #
#                            ###   ###                          #              #
#                                                               #              #
#     #                                                  ##     #              #
#    # #                                                #  #    #              #
#   #   #### # # # ##### # # # # # ###   ### # # # # # #  $ #   #              #
# [ # $    #   # $ #   # $ # $ # $ #   [   # $ # $ #   #    # [ #              #
#   #      # $ #   # [ #   #   #   #       #   #   # $ # [  #   #              #
#    #  [  #   #####   #############       #########   #    #   #              #
#    #      # #                                     # #     #   #              #
#    #       #                                       #      #   #              #
#     #                                                    #    #              #
#     #          @       @       @           @   @         #    #              #
#     #                                                    #    #              #
#     #      #                                       #  $ #     #              #
#     #  $  # #                                     # #   #     #              #
#      #   #   #########   #####################   #   #  #     #              #
#       #  # $ #   #   # @ #   #   #   #   #   #   # $ #  #     #              #
#        # #   # $ # $ #   # $ # $ # $ # $ # $ #   #   # #      #              #
#         ## # # # # # ##### # # # # # # # # # #   # # ##       #              #
#                                                               #              #
#   @                                                       @   #              #
#                                *                              #              #
#                                                               #              #
################################################################################