################################################################################
#      #                                                 #      #              #
#  @   #                                                 #   @  #  # #   # #   #
#      #   $             @            @             $    #      #  #  # #  #   #
####   #        #####        #####        #####          #   ####  ##  #   ##  #
#               #####                     #####                 #              #
#               ##                           ##                 #      ##      #
#                                                               #     #  #     #
#   #####                    #####                    #####     #       #      #
#   #####    $       #####################       $    #####     #      #       #
#   ##             ####      $   $      ####             ##     #     ####     #
#                 #####   @    $    @   #####                   #              #
#                 #####      $ @ $      #####                   ################
#      ################                 ################        #              #
#   ###################   ###########   ###################     #              #
#   ##                                                   ##     #              #
#   #                                                     #     #              #
#                                                               #              #
#          ###      ########       ########      ###            #              #
#        #######    #                     #    #######          #              #
#        #######    # @             $   $ #    #######          #              #
E   #    #######    #                 $   #    #######    #  *  #              #
#          ###      # @             $   $ #      ###            #              #
#                   #                 $   #                     #              #
#                   # @             $   $ #                     #              #
#   #       @       #                     #       @       #     #              #
#   #               #######################               #     #              #
#   #    #######                               #######    #     #              #
#   #    #######              $ $              #######    #     #              #
#   #                                                     #     #              #
#   #                   ###############                   #     #              #
#   #              $    ###############    $              #     #              #
#   #    #######        ###############        #######    #     #              #
#        #######            #######            #######          #              #
#                           #######                             #              #
#                           #######                             #              #
#   $                                                      $    #              #
#        ##########            $            ##########          #              #
#   @    ##########    @               @    ##########     @    #              #
#        ##########         #######         ##########          #              #
#        ##########         #######         ##########          #              #
################################################################################